9 11
...#####...
####...#...
#..#x..####
#.xx......#
#p..#x.x#.#
###.#...#.#
.#..#####.#
.#........#
.##########
...........
...........
...........
...........
...........
...........
...........
....ooooo..
...........